============================
=............==............=
=.====.=====.==.=====.====.=
=*====.=====.==.=====.====*=
=.====.=====.==.=====.====.=
=..........................=
=.====.==.========.==.====.=
=.====.==.========.==.====.=
=......==....==....==......=
======.=====.==.=====.======
     =.=====.==.=====.=     
     =.==..........==.=     
     =.==.===--===.==.=     
======.==.=      =.==.======
      ....=      =....      
======.==.=      =.==.======
     =.==.========.==.=     
     =.==..........==.=     
     =.==.========.==.=     
======.==.========.==.======
=............==............=
=.====.=====.==.=====.====.=
=*====.=====.==.=====.====*=
=...==................==...=
===.==.==.========.==.==.===
===.==.==.========.==.==.===
=......==....==....==......=
=.==========.==.==========.=
=.==========.==.==========.=
=..........................=
============================