=========..=========
=..................=
=.=.============.=.=
=.=.=...====...=.=.=
=.=...=......=...=.=
=.================.=
=.=*............*=.=
=.=======..=======.=
=.......==.=.......=
=.=====.=..=.=====.=
........=.==........
=.=====.=..=.=====.=
=.=...=......=...=.=
=.=...=......=...=.=
=.=...=.====.=...=.=
=.=..............=.=
=.=...=.====.=...=.=
=.=*..=.=  = =..*=.=
=.=====.====.=====.=
=..................=
=========..=========